1111111111111111111111111111111
1C00000100C1C000001C00000000001
11111101011111011011101C0111101
1E000C000100010100100010000C001
111111110001010001101C111011101
1C000011111100010000111C1010001
111110001C000111110010001010101
1000101011110100000010111010101
1C10101010100101110010000010101
1010001000000100C1000011101P1C1
1111111111111111111111111111111